addit – attán   antaa
ahkásaš   ikäinen
ahte   että
ain   yhä
aitto   nyt, -pa, -pä, -han, -hän
ala   päälle
albma   oikea, aito, kunnon
albmi – almmi   taivas
alde   päällä, -ltä
ale   älä (kieltoverbin yks2p imperatiivi)
alit – aliha, # =   sininen
allat – allaga, #alla   korkea
allergiija – allergiija   allergia
almmái – albmá   mies
amas – apmasa, # =   vieras, outo 
amma nu?   eikö niin?
Anár – Anára   Inari
asehaš – asehačča, #asehis   ohut (litteistä esineistä)
aski – askki   syli
as'sái – as'sá, #as'sás   paksu (litteistä esineistä)
astat – asttan   ehtiä, joutaa
áddet – ádden   ymmärtää
áddjá – ádjá   isoisä
áhčči – áhči   isä
áhkku – áhku   isoäiti
áibbas   aivan
áidi – áiddi   aita
áidna   ainoa
áigá   kauan sitten
áigi – áiggi   aika
áigut – áiggun   aikoa
áiti – áitti   aitta
ákšu – ákšu   kirves
álddagas – álddagasa   salama
áldu – álddu   vaadin
álggos   aluksi, ensin
álgit – álggán   alkaa
álki – álki, #álkis   helppo
álo   aina
ámbulansa – ámbulanssa   ambulanssi
árrat   aikaisin
árrat – árrada, #árra   varhainen
ártet – ártega, #ártegis   erikoinen, outo
ássat – ásan   asua
ástmá – ástmmá   astma
ášši – ášši   asia (astevaihteluton!)
áŧestit – *áŧestan   ahdistaa
ávki – ávkki   hyöty
badjánit – badjánan   kohota
badjedilli – badjedili    paimentolaisporonhoito
badjel   yli
badjeolmmoš   poronhoitaja
bahá – bahá, #bahás   paha; vihainen (koira)
bahča – bahččaga, # =   pahanmakuinen, karvas
baicce   sen sijaan
bajábealde   yläpuolella
bajil   päällepäin
bajimus – bajimusa   ylin, ylimmäinen
ballat – balan (+ lok.)   pelätä jtak
bargat – barggan   työskennellä, tehdä (työtä tms.); pyrkiä
bargobáiki   työpaikka
bargu – barggu   työ
bassat – basan   pestä
bastil – bastila, #bastilis   terävä
-bat   -kos, -kös (kysyvä liitepartikkeli)
batnit – banán   kehrätä
bábir – báhpára   paperi
báddi – bátti   naru, nauha
bádji – báji   paja
báhcit – bázán   jäädä
báhkka – báhka   paketti
báhkket – báhkken   pakata, paketoida
báidi – báiddi   paita
báiki – báikki   paikka
báitit – *báittán   paistaa (auringosta)
bálddas   vieressä, -stä
bálddis – báldá   pallas
báldii   viereen
bálggis – bálgá   polku
bálkestit – bálkestan   heittää, viskata
bárdni – bártni   poika, nuori mies
bárgut – bárggun   parkua; huutaa (lokeista tms.)
bárru – báru   aalto
bátni – báni   hammas
bávččas – bákčasa   kipu; kipeä
beaivi – beaivvi   päivä; aurinko
beaivit   päivällä; päivisin
beakkán – beakkána, #beakkánis   kuuluisa
beal   puoli (kellonaikaa ilmaistaessa)
bealde   puolella, -lta
beallai   puolelle
bealli – beali   puoli
beallji – bealji   korva
beana – beatnaga   koira
bean'na – beanna   kynä
beannot   puolitoista
beaŋka – beaŋkka   penkki
bearaš – bearraša   perhe
bearjadat – bearjadaga   perjantai
beassat – beasan   päästä
beas'si – beassi   tuohi
beavdi – beavddi   pöytä
ben'ne – benne   penni
bensiidna – bensiinna   bensiini
beroštit – beroštan   välittää
bidjat – bijan   laittaa, panna
biđget – biđgen   rikkoa, hajottaa
biđus – biđđosa   poronkäristys
biebmu – biepmu   ruoka
biel'lu – biellu   (soiva) kello
biergu – bierggu   liha
bihttá – bihtá   pala, palanen
Biret–Iŋgá – -Iŋggá   naisen nimi
birra   ympäri(-llä,-ltä); jstak asiasta, jtak koskien
bivttas – biktasa   vaate
bivval – bivvala, #bivvalis   lauha
boađus – bohtosa   tulos
boagán – boahkána   vyö
boagustit – boagustan   nauraa
boahtte   seuraava, ensi (ajan ilmauksissa)
boaris – boarrása, #boares   vanha
boasta – boastta   posti
boazoalmmái   poromies
boazoolmmoš   poronhoitaja
boazu – bohcco   poro
bodni – botni   pohja; (harv.) alakerta
boradit – boradan   syödä (ateria)
borgemánnu – -mánu   elokuu   
borramuš – borramuša   ruoka
borranmiella   ruokahalu
borrat – boran   syödä
borvet – borven   pöyhiä, penkoa
botnjat – bonjan   vääntää
bovdna – bovnna   (iso) mätäs
buhtis – buhttása, #buhtes   puhdas
buktit – buvttán   tuoda
bumpet – bumpen   pumpata
buohcat – buozan   sairastaa
buohcceviessu   sairaala
buohcci – buohcci   potilas
buohkat (mon.)   kaikki (ihmisistä)
buoidi – buoiddi, #buoiddes   lihava; (subst.) kiinteä rasva, läski
buolaš – buollaša   pakkanen
buollit – buolán   palaa
buorre – buori, # =   hyvä
buot   kaikki; (superlatiivin yhteydessä) kaikkein
buozus   sairaana
bures   hyvin
bures boahtin   tervetuloa
busir – busira   pusero
bus'sá – bussá   kissa
buvri – buvrri   kömmänä, puura
buvssat (mon.)   housut
ceaggát – ceaggán   olla pystyssä, törröttää
ciellat – *cielan   haukkua (koirasta)
coahki – coagi, #coages   matala (vedestä)
coggat – cokkan   sujauttaa, panna jhkin; pukea (vaate); tunkea
cubborássi   korte
cuoŋománnu – -mánu   huhtikuu
cuoppu – cubbo   sammakko
čađa   läpi
čaibmat – čaimman   nauraa
čakča – čavčča   syksy
čakčamánnu – -mánu   syyskuu
čakčat   syksyllä; syksyisin
čalbmi – čalmmi   silmä
čatnat – čanan   sitoa
čábbát   kauniisti
čáhci – čázi   vesi
čáhppat – čáhppada, #čáhppes   musta
čáhppesmuorji   variksenmarja
čáihni – čáihnni   pisama
čájehit – čájehan   näyttää
čákŋat – čáŋan   kömpiä (jostain läpi, sisään), mennä sisään (esim. pienestä oviaukosta)
čála – čállaga   kirjoitus   
čál'li – čál'li   sihteeri
čállit – čálán   kirjoittaa
čáppis – čábbá, #čáppa   kaunis
čárvet – čárven   puristaa (kerran)
čárvut – čárvvun   puristaa, puristella
čeabi – čeahpáha   kaula
čeahci – čeazi   setä (isää nuorempi)
čeahppi – čeahpi, #čeahpes   taitava
čiegus – čihkosa, # =   salainen, kätketty
čielggas – čielgasa, #čielga   selvä   
čieŋal – čiekŋala, #čiekŋalis   syvä
čierostuddat – čierostuttan   tehdä itkua
čierrut – čierun   itkeä
čieža – čieža   seitsemän
čihččet – čihččeda   seitsemäs
čikŋa – čiŋa   koriste, koriste-esine
čiŋadit – čiŋadan   koristautua
čoaggit – čoakkán   kerätä
čoalli – čoali   suoli
čoavji – čoavjji   vatsa, maha
čogas – čohkasa, #čohka   terävä (päästä, kärjestä, ei reunasta)
čohkánit – čohkánan   istuutua
čohkkát – čohkkán   istua
čuoččastit – čuoččastan   nousta seisomaan
čuoččat   seisaalla
čuodjat – *čuojan   soida
čuođát – čuođáda   sadas
čuođi – čuođi   sata
čuohppat – čuohpan   leikata
čuoigat – čuoiggan   hiihtää
čuorbi – čuorbbi, #čuorbbes   taitamaton, tunari
čuorpmas – čuorbmasa   (jää)rae   
čuorvut – čuorvvun   huutaa
čuovvut – čuovun   seurata
čuožžut – čuoččun   seistä
čurvet – čurven   huutaa (kerran)
dadjat – dajan   sanoa
dahkat – dagan   tehdä
dakkár – dakkára   sellainen
dalán   heti
dalle   silloin
dan vuoro   sillä kertaa, sillä erää
danin   siksi
danin go   siksi että, siksi koska
daŋas – dakŋasa   varpu
das'sá   ... sitten, siitä asti (ajan ilmauksissa)
dat – dan   se; (puhek.) hän
datte   silti, siitä huolimatta
davás   pohjoiseen
dá   tässä
dábálaččat   tavallisesti
dábálaš – dábálačča, # =   tavallinen
dáfus   jkun suhteen, jssak suhteessa
dáhttut – dáhtun   tahtoa, haluta
dáidit – dáiddán   taitaa
dál   nyt
dálá   nykyinen, tämänhetkinen
dálki – dálkki   sää
dálkkas – dálkasa   lääke
dállu – dálu   talo
dálostallat – dálostalan   asua, pitää taloa
dáŋket – dáŋken   tankata
dáppe   täällä
dárbbašit – dárbbašan   tarvita
dárkilit   tarkasti
dát – dán   tämä
dávda – dávdda   tauti
dávjá   usein
dávvir – dávvira   tavara
Dáža – Dáža   Norja
dáža – dáža   norjalainen (ihminen)
de   kyllä (vahvistava myönt. partikkeli)
deadja – deaja   tee
deaivat – deaivvan   tavata, kohdata; osua; sattua, tapahtua sattumalta
dearbmi – dearpmi   törmä
dearvvahallat – dearvvahalan   tervehtiä (toisiaan)
dearvvas – dearvasa, # =   terve
Deatnu – Deanu   Teno (joennimi)
deattán – deattána   painajainen
dehálaš – dehálačča, # =   tärkeä
deike   tänne
dieđusge   tietysti, tietenkin
diehppi – diehpi   tupsu
diehtit – dieđán   tietää
dieppe   siellä (missä sinä olet)
diet – dien   se (joka on sinulla)
dievas – dievvasa, # =   täysi
dihto   tietty
dihtor – dihtora   tietokone
dii – din   te (ei kahdesta)
diibmá   viime vuonna
diibmu – diimmu   kello
dikšut – divššun   hoitaa
dilli   (olo)tila
dimis – dipmása, #dipma   pehmeä
diŋga – diŋgga   esine
divrras – divrasa, # =   kallis
doaččis – doažžása, #doaččes   hiljaa virtaava (vedestä, joesta)
doahput – doabun   tarttua (useisiin esineisiin), ottaa kiinni (useita)
doai – dudno   te (kaksi)
doallat – doalan   pitää (kiinni tms.)
doalvut – doalvvun   viedä
doapmat – doaman   kiiruhtaa
doarggistit – doarggistan   täristä, väristä
doarvái   tarpeeksi
doavttir – doaktára   lääkäri
dohko   sinne
dohppet – dohppen    tarttua (kerran), ottaa kiinni (yksi)
doidit – doiddán   huuhtoa
dolastallat – dolastalan   pitää nuotiota
dolin   muinoin
dolla – dola   tuli
dol'let – dol'len   tarttua kiinni; suunnata, lähteä jhkin suuntaan
dološ – doloža, # =   muinainen
don – du   sinä
doppe   siellä
dorski – dorskki   turska
dot – don   tuo (tuolla etäällä)
dovdat – dovddat   tuntea
duđavaš, # =   tyytyväinen
duhtat – duđan   tyytyä
duhtavaš – duhtavačča, # =   tyytyväinen
duodji – duoji   käsityö
duohkái   taakse
duohken   takana, takaa
duohta – duođa, # =   tosi
duol'let dál'le   silloin tällöin
duol'lu – duollu   tulli
duorastat – duorastaga   torstai
duorššas – duoršasa, # =   litteänaamainen, lättänaamainen
duot – duon   tuo (tuolla)
duottar – duoddara   tunturi, tundra, vuoret
dus   sinulla
dušše   vain
duš'ši – dušši   turhuus, joutava asia, tyhjänpäiväisyys
dutkat – dutkkan   tutkia
eadni – eatni   äiti
eahkes   illalla
eahket – eahkeda   ilta
eahki – eagi   setä (isää vanhempi)
eal'li – eal'li   eläin
eallit – ealán   elää
eallu – ealu   (poro)elo, tokka
eambbo   enemmän
eamit – eamida   vaimo
eana – eatnama   maa (ei valtio)
eanu – edno   eno
eará   muu
easkká   äskeinen (vain attrib.)
ehtemas – ehtemasa   juolukka
erenomáš – erenomáža, # =   erityinen
eret   pois
fal   vain  (ei ’only’)
fal'lehit – fal'lehan   hyökätä
falli – fali, #falis   nopea
fanas – fatnasa   vene
fargga   kohta, pian; nopeasti
fas   taas; puolestaan
fasti – fastti, #fasttes   huono (ilma); iljettävä, hyvin ruma
fálaldat – fálaldaga   tarjous
fális – fál'lá   valas
fállat – fálan   tarjota
fápmu – fámu   voima
fárta – fártta   vauhti
fáruhit – fáruhan   varoa
fárus   mukana
feaskkir – feaskára   eteinen
feber – febera   kuume
fertet – ferten   täytyä (olla pakko)
fierbmi – fierpmi   verkko
figgat – fikkan   pyrkiä
fiilu – fiillu   viila
fioleahtta – fioleahta, # =   violetti
fiskat – fiskada, #fiskes   keltainen
fitnat – finan   käydä
funet   huonosti
fuolla – fuola   huoli
fuotni – fuoni, #fuones   huono
gahččat – gahčan   pudota
gaikut – gaikkun   kiskoa, repiä
gal   kyllä (vahvistava myönt. partikkeli)
galgat – galggan   täytyä
gal'le – galli   montako
gal'lestallat – gal'lestalan  (+ obj.!)   vierailla, käydä kylässä
galmmas – galbmasa, #galbma   kylmä
garas – garrasa, #garra   kova
garrasit   kovasti, kovaa
garvit – garvván   kiertää
gaskavahkku – gaskavahku   keskiviikko
gaskii   väliin
gaskkas   välissä, -stä
gassat – gassaga, #gassa   paksu (ei litteistä esineistä)
gavjjat (mon.)   pöly
gáddi – gátti   ranta
gáddit – gáttán   luulla
gádjut – gájun   pelastaa
gáfestallat – gáfestalan   juoda kahvia
gáffe – gáfe   kahvi
gáhkku – gáhku   kakku
gáhttu – gáhtu   katto
gákti – gávtti   lapintakki
gálbi – gálbbi   vasikka
gálvu – gálvvu   tavara
gáma – gápmaga   kenkä
gámmir – gámmira   makuuhuone
gánda – gándda   poika
gárdi – gárddi   aitaus, erit. poroaita
gártat – gárttan   joutua
gárvvis – gárvása, #gárvves   valmis
gárži – gáržži, #gáržžes   kapea
gáskkestit – gáskkestan   puraista
gávccát – gávccáda   kahdeksas
gávcci – gávcci   kahdeksan
gávdnat – gávnnan   löytää
gávdnot – gávdnon   löytyä
gávnnit (mon.)   vuodevaatteet
gávpegas – gávpegasa   kauppias
gávpi – gávppi   kauppa
gávpot – gávpoga   kaupunki
gávppašit – gávppašan   käydä kauppaa; käydä ostoksilla
gázzi – gácci   seurue; perhekunta; porukka
-ge   -kin
geađgi – geađggi   kivi
geahčadit – geahčadan   katsella (ympärilleen tms.)
geahčai   luo, luokse (kotiin)
geahččat – geahčan   katsoa, katsella
geahčen   luona (kotona), luota (kotoa)
geahči – geaži   kärki, pää (’end’)
geaidnu – geainnu   tie
geardi – gearddi   kerta
geargat – gearggan   ehtiä (ajoissa); saada valmiiksi, keretä (työstä tms.)
geassemánnu – -mánu   kesäkuu
geassi – geasi   kesä
geassit   kesällä; kesäisin
geassit – geasán   vetää
geasuhit – geasuhan   houkutella
geavŋŋis – geavgŋá   suuri koski, köngäs
geažes   kuluttua (ajasta)
-ges   puolestaan, vuorostaan
giđđat   keväällä; keväisin
gieddi – gietti   kenttä
gielda – gieldda   kunta
gielis – giellása   vale   
gielká – gielkká   kelkka
gierdavaš – gierdavačča, # =   kärsivällinen
gieskat   hiljattain, vähän aikaa sitten
gievdni – gievnni   ämpäri; (kahvi)pannu
gievkkan – gievkkana   keittiö
gievra – gievrra, #gievrras   vahva
gii – gean   kuka
giitu   kiitos
gilli – gili   kylä
girdnu – girtnu   kirnu
girjái – girjá, #girjás   kirjava
girji – girjji   kirja
gitta   kiinni; jhkin saakka
-go   -ko, -kö (kysyvä liitepartikkeli)
go   kun; kuin
goabbá – goappá   kumpi
goahti – goađi   kota
goallut – goalun   palella
goalmmát – goalmmáda   kolmas
goarrunmašiidna   ompelukone
goarrut – goarun   ommella
goas   koska, milloin
goaski ¬– goaskki   täti (äitiä vanhempi)
goaskin – goaskima   kotka   
gobmi – gopmi   kummitus
gohppa – gohpa   kuppi
gohttá – gohtá   leivos, viineri
goikkis – goikása, #goike-   kuiva
goit   kuitenkin; ainakin
goittotge   kuitenkin; ainakin
gokčat – govččan   peittää; sulkea (ikkuna, ovi tms.)
gokko   missä kohden, missä (täsmälleen)
golbma – golmma   kolme
golgat – *golggan   valua, vuotaa
golggotmánnu – -mánu   lokakuu
gollat – *golan   kulua (ajasta, rahasta, yms.)
gol'li – golli   kulta
gonagas – gonagasa   kuningas
gopmánit – gopmánan   kaatua kumoon, ylösalaisin
gorostat – gorostaga   ommel, ompelulanka
gorut – goruda   vartalo   
gos   missä, -stä
govččas – gokčasa   peitto, peite
govdat – govdaga, #govda   leveä
guđát – guđáda   kuudes
guhká   kauan
guhkki – guhki, #guhkes   pitkä
guhkkin   kaukana
guhtta – guđa   kuusi
guktot – guktuid (mon.)   molemmat
guldalit – guldalan   kuunnella
gullat – gulan   kuulla
gul'lot – gul'lon   kuulua
gulul   hiljaa, hitaasti
guohca – guohccaga, # =   mätä, pilaantunut
guoibmi – guoimmi   puoliso; avopuoliso; kumppani
guokte – guovtti   kaksi
guolli – guoli   kala
-guoras   ääressä, -stä, laidassa, -sta
guorus – gurrosa, #guoros   tyhjä
guos'si – guossi   vieras
guovddáš – guovddáža   keskus
guovdu   keskellä
guovlalit – guovlalan   vilkaista, kurkistaa
guovlat – guovllan   kurkata, kurkistaa
guovttá   kahden, kahdestaan
guovtte beale   kahta puolta
guovvamánnu – -mánu   helmikuu
gurput – gurppun   kantaa
-gurrii   ääreen, laitaan
gurut – guruha, # =   vasen
gussa – gusa   lehmä
gusto   näköjään
-han   -han, -hän
hálbi – hálbbi, #hálbbes   halpa
háleštit – háleštan   jutella
hálidit – hálidan   haluta
hállat – hálan   puhua
hárve   harvoin
hávil   kerralla, yhdellä kertaa
hávvi – hávi   haava
headju – heaju, #heajos   heikko, huono
Heahttá – Heahtá   Hetta (paikannimi)
Heandarat   miehen nimi (Henrikki)
heargi – hearggi   porohärkä
hearvái – hearvá, #hearvás   huvittava
heasta – heastta   hevonen
heittot – heittoga, #heittogis   heikko, huono
hildu – hildu   hylly
hirbmat – hirbmada, # =   hirveä, hirmuinen
hirsa – hirssa   hirsi
hivsset – hivssega   vessa
hoavda – hoavdda   johtaja
holga – holgga   vave, poikkipuu (verkkojen kuivaamiseen tms.)
hui   hyvin, erittäin, varsin
huikit – huikkán   huutaa
huikkádit – huikkádan   huudahtaa
hukset – huksen   rakentaa (talo, rakennus)
idja – ija   yö
iđ'đes   aamulla
iđit – iđida   aamu
ieš alddes   itse asiassa
iešguđetlágan – -lágana, # =   monenlainen, erilainen
iežas   (hänen) oma
ihkku   yöllä; öisin
ihttin   huomenna
ikte   eilen
illu – ilu   ilo
irgi – irggi   poikaystävä; sulhanen
isit – isida   aviomies
iskat – iskkan   koettaa (kädellä tms.)
issoras – issorasa, # =   hirveä, kamala, pelottava
ivdnái – ivdná, #ivdnás   jkun värinen
ivdni – ivnni   väri
ja   ja
-jahkásaš   -vuotias
jahki – jagi   vuosi
jal'la – jalla, #jallas   hullu
jaskat – jaskada, #jaskes   hiljainen
jaskkodit – jaskkodan   hiljetä
já   jaa, vai niin
jáffut (mon.)   jauhot
jáhkka – jáhka   takki
jáhkkit – jáhkán   uskoa
jállu – jálu, #jálus   rohkea, peloton
jápmit – jámán   kuolla
jávkkehit – jávkkehan   kadota (nopeasti, yllättäen tms.)
jávri – jávrri   järvi
jearahit – jearahan   kysellä
jearrat – jearan   kysyä
jeđ'đet – jeđ'đen   lohduttaa
jienádit – jienádan   äännähtää
jierbmái – jierbmá, #jierbmás   järkevä
jietna – jiena   ääni
jietnadit – jietnadan   ääntää, äännähtää
jitnosit   ääneen
jo   jo
joatkit – joatkkán   jatkaa
joavdat – joavddan   päästä perille, ehättää
johtil – johtila, #johtilis   nopea
johtu   kulkeminen, liike
johtui   liikkeelle
jokŋa – joŋa   puolukka
jos   jos
juhkat – jugan   juoda
julla – jula   jylinä, jyminä
juo   kyllä; jo
juoga – juoidá   jotakin
juogus – juhkosa   jaos   
juohke   joka (‘every’)
juoigat – juoiggan   joikata
juolgi – juolggi   jalka
juos   jos
juovlamánnu – -mánu   joulukuu
juovlaruohtta – juovlaruohta   jouluaatto
jurddašit – jurddašan   ajatella
juvla – juvlla   rengas
kafea   kahvila
kansliija – kansliija   kanslia
kás'sa – kássa   laatikko
kilo – kilo   kilo
kilobealle – kilobeale   puoli kiloa
kursa – kurssa   kurssi
lađas – lađđasa   nivel   
lahka   lähellä
lahkonit – lahkonan   lähestyä
lasi   lisää
lasihit   lisätä
lasta – lastta   lehti
latnja – lanja   huone
lavdnji – lavnnji   turve
láđ'đi – láđ'đi   verka
láđis – láđđása, # =   lempeä
láhtterátnu   matto
láhtti – láhtti   lattia
láibi – láibbi   leipä
láibut – láibbun   leipoa
láigolaš – láigolačča   vuokralainen
lássa – lása   lasi; ikkuna
lássaliinnit (mon.)   verhot
láttu – láddo   lampi
lávet – láven   olla tapana, ”ruukata”
lávlla – lávlaga   laulu
lávlut – lávllun   laulaa
lávvardat – lávvardaga   lauantai
leabbut – leappun   levitellä
leahkastit – leahkastan   aukaista, avata (ovi tms.)
leaibi – leaibbi   leppä
leat – lean   olla
leat fuolas   olla huolissaan
leat ilus   olla iloinen
leat oidnosis   olla näkyvissä
lebbet – lebben   levittää
liekkas – lieggasa, #liegga   lämmin
lihkkat – lihkan   herätä
lihkolaš – lihkolačča, # =   onnellinen
lihtti – lihti   astia
liigi   liika(a)
liikebiktasat (mon.)   alusvaatteet
liiki – liikki   iho
liikká   (jostain, siitä) huolimatta, siltikin, kuitenkin
liikot – liikon (+ ill.)   pitää jstak
liiva – liivva   liivi
linis – litnása, #litna   pehmeä
listu – listtu   luettelo, lista
livvadit – *livvadan   maata (sorkkaeläimistä yms.)
loddi – lotti   lintu
logát – logáda   kymmenes
logi – logi   kymmenen
lohkat – logan   sanoa; lukea; laskea; pitää jnak
loktet – lokten   nostaa
lonuhit – lonuhan   vaihtaa (jotain johonkin toiseen)
lossat – lossada, #lossa (~ #los'ses)   raskas, painava
luddet – ludden   halkaista
luhtte   luona, luota
luoddut – luottun   halkoa
luohkká – luohká   mäki
luoikat – luoikkan   lainata
luoitit – luoittán   laskea (alas); laskeutua; päästää (irti)
luomi – luopmána   hilla, lakka
luoppal – luobbala   järvi joen varrella
luossa – luosa   lohi
lusa   luokse
maid   myös; mitä
maiddái   myös
maidege   [ei] mitään
makkár – makkára, # =   millainen
manin   miksi
mannan   viime (ajan ilmauksissa)
mannat – manan   mennä
maŋimus, # =   viimeinen
maŋis   perässä (takanapäin), -stä
maŋŋá   jälkeen; myöhemmin
maŋŋái   perään
maŋŋebárga – maŋŋebárgga   tiistai
maŋŋel   jälkeen
masá   melkein, miltei
mašiidna – mašiinna   kone
Máhtte – Máhte   miehen nimi (Matti)
máhttit – máhtán   osata
máilbmi – máilmmi   maailma
máksit – mávssán   maksaa
mánnu – mánu   kuu; kuukausi
máŋga   monta
máŋggalágan – máŋggalágana, # =   monelainen
máŋgii   monesti
márfi – márffi   makkara
márgariidna – márgariinna   margariini
mátki – mátkki   matka
meahcci – meahci   asumaton alue, erämaa, ”metsä”
mearka – mearkka   merkki
mearkut – mearkkun   merkitä (merkillä)
mearra – meara   meri
mearridit – mearridan   määrätä; päättää (tehdä jtak)
measta   melkein
meattá   ohi
menddo   liian
miehtat – mieđan   myöntyä
miehtá   pitkin
mieiganstuollu – mieiganstuolu   nojatuoli
mielde   mukana, mukaan
miella – miela   mieli; tuuli, mieliala
miel'li – mielli   (jyrkkä) rantatörmä, jokitörmä
miessemánnu – -mánu   toukokuu
miessi – miesi   vasa
mii – man   mikä
mii – min   me (ei kahdesta)
mo   miten, kuinka
moadde – moatti   muutama
moai – mun'no   me (kaksi)
moarsi – moarsi   tyttöystävä; morsian
moddját – moddján   hymyillä
mohkki – mohki   mutka
mohtor – mohtora   moottori
mojohallat – mojohalan   hymyillä
morihit – morihan   havahtua
muđui   muuten
muhto   mutta
muhtumin   joskus, toisinaan
muhtun – muhtuma   joku
muitalit – muitalan   kertoa
muitit – muittán   muistaa
mun – mu   minä
muohtu – muođu   poski; (monikossa myös:) kasvot
muorji – muorjji   marja
muorra – muora   puu
muoŧŧá – muoŧá   täti (äidin nuorempi sisar)
naba   entä, entäpä
nagadit – nagadan   kyetä, jaksaa
namma – nama   nimi
nanus – nannosa, #nana   luja, kestävä
nágget – nággen   inttää, väittää vastaan
náhkki – náhki   nahka
návet – náveha   navetta
nealgut – nealggun   nähdä nälkää, tulla (hyvin) nälkäiseksi
niehku – niegu   uni
nieida – nieidda   tyttö
nisojáffut   vehnäjauhot (mon.)
nisoláibi – nisoláibbi   pulla
nissut – nisun   niistää
nisu – nissona   nainen
njammat – njaman   imeä
njáhkat – njágan   hiipiä
njálbmi – njálmmi   suu
njálggis – njálgá   makeinen
njálggis – njálgá, #njálgga   hyvänmakuinen
njárga – njárgga   niemi
njávgut – *njávggun   naukua
njávkkadit – njávkkadan   silittää, silitellä (kädellä)
njealját – njealjáda   neljäs
njeallje – njealji   neljä
njiedjat – njiejan   laskeutua (rinnettä tms.)
njoahcudit – njoahcudan   hidastaa
njoallut – njoalun   nuolla
njoammil – njoammila   jänis
njoarostit – njoarostan   heittää suopunkia
njoarrat – njoaran   kaataa (nestettä)
njuiket – njuiken   hypätä
njuikut – njuikkun   hyppiä
njukčamánnu – -mánu   maaliskuu
njunni – njuni   nenä; nenäke (maankohoumassa)
njuoskkas – njuoskasa, #njuoska   märkä
njuovčča – njuokčama   kieli (‘tongue’)
njuovvat – njuovan   teurastaa
nohkastit – nohkastan   nukahtaa (äkkiä); nukkua (hetki)
nohkat – *nogan   kulua; loppua
nohkkat – nohkan   nukahtaa; (harv.) nukkua
nu   niin
nubbi – nuppi   toinen
nugo   niin kuin, kuten
nummir – nummira   numero
nuolastit – nuolastan   riisua (äkkiä, nopeasti tms.)
nuollat – nuolan   riisua
nuorra – nuora, # =   nuori
nuorvvu – nurvo   nuha
nuov'vebáddi – -bátti   hamppuköysi, -naru
o   oi
oabbá – oappá   sisar
oađđinlatnja   makuuhuone
oađđit – oađán   nukkua
oaggut – oakkun   onkia
oahpahallat – oahpahalan   opetella
oahpaheaddji – oahpaheaddji   opettaja
oahpahit – oahpahan   opettaa
oahpis – oahppása, #oahpes   tuttu
oahppat – oahpan   oppia
oaidnit – oainnán   nähdä
oainnat   näet (partikkeli)
oaivi – oaivvi   pää (’head’)
oalle   varsin, sangen
oanehaš – oanehačča, #oanehis   lyhyt
oapman – oapmana   uuni
oarpmealle – oarpmeale   naisserkku
oastit – oasttán   ostaa
oažžut – oaččun   saada
obbalággá – obbalákká   umpisuoli
odne   tänään
ođas – ođđasa, #ođđa   uusi
ođđajagimánnu – -mánu   tammikuu
ohcat – ozan   etsiä
Ohcejohka – Ohcejoga   Utsjoki
oidnot – oidnon   näkyä
ojá   vai niin
okta – ovtta   yksi
oktii   kerran
oktiibuot   yhteensä
okto   yksin
olgeš – olgeša, # =   oikea (vs. vasen)
ollege   [ei] ollenkaan, lainkaan
ollesolmmoš   aikuinen
ollis – ol'lása, #olles   koko(nainen); aikuinen
ollu (+ mNom)   paljon
olmmoš – olbmo   ihminen
olus   [ei] juurikaan, paljonkaan
oppa   koko (= ‘entire’)
oránša – oránšša, # =   oranssi
ore – ore   ori
orrunlatnja   olohuone
orrut – orun   asua; olla (aloillaan tms.); vaikuttaa joltakin
ortnet – ortnega   järjestys
orustit – orustan   pysyhtyä
otne   tänään
ovccát – ovccáda   yhdeksäs
ovcci – ovcci   yhdeksän
ovdal   ennen
ovdalgo   ennen kuin
ovddas   edessä, -stä
ovddeš – ovddeža, # =   entinen
ovddit – ovddibu   edellinen
ovdii   eteen
rabas – rahpasa, # =   avoin
rahpat – raban   avata
rastá   poikki
rašši – raši, #rašeš   arka, (vähän) kipeä
ravda – ravdda   reuna
rádjai   johonkin saakka
ráfálaš – ráfálačča, # =   rauhallinen
ráfot – ráfon   rauhoittua
ráhkadit – ráhkadan   valmistaa, tehdä (jokin esine, ruokaa, tms.)
ráhkis – ráhkkása, # =   rakas
ráhppa – ráhpa   rappu, porras
ráigi – ráiggi   reikä
ránis – rátnása, #ránes   harmaa
rán'njá – ránnjá   naapuri
rássi – rási   ruoho, heinä; kukka
rátnu – ránu   raanu
ráv'vet – ráv'ven   neuvoa
rehkenastit – rehkenasttán   laskea (‘to count’)
reive – reivve   kirje
riegádanbeaivi – -beaivvi   syntymäpäivä
riegádit – riegádan   syntyä
riehpu - riebu   raukka, parka
riekta   oikein
rihča – rihččaga, # =   kitkerä
riika – riikka   valtio
rikkis – riggá, # =   rikas
riŋget – riŋgen   soittaa (puhelimella)
riš'ša – rišša   tulitikku; rikki
roggi – rokki   kuoppa; uoma, jokilaakso
rohtu – rođu   lehto; ryteikkö
ropmi – romi, #romes   ruma
rotnu – ronu   maho vaadin
ruhta – ruđa   raha
ruohttat – *ruohtan   juosta (nelijalkaisista)
ruoksat – ruoksada, #rukses   punainen
ruoksát – ruoksán   näkyä, olla punaisena, “punottaa”
ruoksi – ruovssi   tuumi, vedin (utareissa)
ruoktot   kotiin; takaisin
ruoktu – ruovttu   koti
ruoná – ruoná, # =   vihreä
ruovdi – ruovddi   rauta
ruovgat – *ruovggan   roukua (poron ääntelystä)
ruovttoluotta   takaisin
ruškat – ruškada, #ruškes   ruskea
ruški – ruškki   ruska
ruvssodit – ruvssodan   punastua, tulla punaiseksi
sabet – sabeha   suksi
sadji – saji   paikka, sija
salla – sala   syli
sarrit – sarrida   mustikka
savnnjašit – savnnjašan   pudistella, ravistella
sáhka – sága   juttu, puhe, puheenaihe, kerrottava
sáhttit – sáhtán   voida (olla mahdollista), saattaa
sáidi – sáiddi   sei
sákta – sávtta   mehu
sámil – sámmála   sammal   
sápmelaš – sápmelačča   saamelainen
Sápmi – Sámi   Lappi
sápmi – sámi   saame(lainen), saame-
sávdni – sávnni   sauna
sávza – sávzza   lammas
seaggi – seakki, #seakka   ohut (ei litteistä esineistä)
seahkka – seahka   säkki, pussi
sealgádit – sealgádan   antaa selkään, rökittää
seamma   sama
seammalágan – seammalágana, # =   samanlainen
seammás   samassa, saman tien
seaŋga – seaŋgga   sänky
seavdnjat – seavdnjada, #sevdnjes   pimeä
seavvit – seaván   vilkuttaa
sieđga – sieđgga   paju
siessá – siesá   täti (isän sisar)
sihtat – siđan   pyytää
sii – sin   he (ei kahdesta)
siida – siidda   siita, porokylä
silba – silbba   hopea
silki – silkki   silkki
Sirbmá – Sirpmá   Sirma (paikannimi)
Sire   naisen nimi (Siiri)
sisa   sisään, sisälle
siskkobealde   sisäpuolella
siste   sisällä, -ltä
skadjá – skajá   venevaja
skábmamánnu – -mánu   marraskuu
skáhpi – skábi   pihlaja
skáhppe – skáhpe   kaappi
skálla – skála   kalina, kilinä
skállat – *skálan   kalista, kilistä
skibir – skihpára   kaveri
skier'ri – skierri   vaivaiskoivu
skurbat – skurbban   kopeloida
skuvla – skuvlla   koulu
smávis – smáv'vá, #smávva   hyvin pieni, pikkuinen
smiehttat – smiehtan   miettiä
snuolga – snuolgga   räkä
soahki – soagi   koivu
soai – sudno   he (kaksi)
sof'fá – soffá   sohva
sohka – soga   suku
sohkar – sohkkara   sokeri
sokta – sovtta   vaahto
solon – solona   hammastikku   
somá – somá, #somás   mukava, hauska
sotnabeaivi – soatnabeaivvi   sunnuntai
son – su   hän
spiidni – spiinni   sika
stál'la – stálla   talli
stereot   stereot
stoahkat – stoagan   leikkiä
stoarbma – stoarpma   myrsky
stohpu – stobu   talo, mökki
studeanta – studeantta   opiskelija
stuhkka – stuhka   palanen, kappale
stuŋgehit – stuŋgehan   rynnätä kimppuun
stuollu – stuolu   tuoli
stuoris – stuor'rá, #stuorra   suuri
stuorrut – stuorun   suureta, kasvaa isommaksi
suhkat – sugan   soutaa
suhtadit – suhtadan   kiukutella
suhttat – suhtan   suuttua
suohkat – suohkada, #suhkkes   sakea, tiheä
suohtas – suohttasa, # =   mukava, hauska
suoidnemánnu – -mánu   heinäkuu
suoli   salaa
suolu – sul'lo   saari
suonjar – suotnjara   säde
Suopma – Suoma   Suomi
suoskat – suoskkan   pureskella
suovasbiergu   savuliha
surbmit (mon.)   suurimot
suvrris – suvrása, #suvrra   hapan
šaddat – šattan   kasvaa; tulla joksikin; joutua
šaldi – šalddi   silta
šat   enää
šearrat – šearrada, #šer'res   kirkas
šear'rát – *šear'rán   loistaa, paistaa kirkkaasti
šiega – šiega, # =   kiltti, hyvätapainen
šiehttat – šiehtan   sopia; mahtua
šillju – šilju   piha
šleađgut – *šleađggun   välkkyä
šlundut – šlunddun   masentua
šukkuláde – šukkuláde   suklaa
šuohkkit – šuohkán   huokailla
šuvva – šuva   kohina, suhina
šuvvat – *šuvan   kohista, suhista
telefonnummir   puhelinnumero
telefovdna – telefovnna   puhelin
televišuvdna – televišuvnna   televisio   
tente – tentte   tentti
turista – turistta   turisti
uhcci – uhci, #uhca   pieni
ujostallat – ujostalan   ujostella
uksa – uvssa   ovi
universitehta – universitehta   yliopisto
un'ni – unni, #unna   pieni
ustit – ustiba   ystävä
vahkku – vahku   viikko
vaikko   vaikka
varas – varrasa, # =   tuore
varra – vara   veri
váháš   vähän
váhnemat (mon.)   vanhemmat
váiban, #váiban   väsynyt (oik. partis. perf. verbistä váibat)
váibat – váibban   väsyä
váile   vaille (kellonaikaa ilmaistaessa)
váivi, #váivves   ikävä, vaivalloinen
váldit – válddán   ottaa
válljet – válljen   valita
váralaš – váralačča, # =   vaarallinen
várra   kai, varmaankin
várri – vári   vaara, vuori, tunturi
várta – vártta   vartti, neljännestunti
vástidit – vástidan   vastata
váttis – váddása, #váttes ~ #váttis   vaikea
vázzilit – vázzilit   lähteä kävelemään
vázzit – váccán   kävellä; käydä (koulua tms.)
veadjit – veaján   jaksaa; voida (hyvin, huonosti, tms.)
veahčir – veahčira   vasara   
veahkehit – veahkehan   auttaa
veahkki – veahki   apu
veajuheapmi   voimaton
veal'lát – veal'lán   maata
vejolaš – vejolačča, # =   mahdollinen
vel   vielä
velá   vielä
ver'rát – ver'ráha   veräjä
viđát – viđáda   viides
viehka   melko, aika
viehkat – viegan   juosta (kaksijalkaisista)
vielgat – vielgada, #vilges   valkoinen
viellja – vielja   veli
vielppis – vielpá   koiranpentu
vierru – vieru   tapa
viessu – viesu   talo
viežžat – vieččan   hakea
vihtta – viđa   viisi
viimmat   viimein
vilbealle – vilbeale   miesserkku
visot   kaikki
vis'sa   kai, varmaankin
visti – vistti   asunto
viššal – viššala, #viššalis   ahkera, viitseliäs
viššat – višan   viitsiä
Vulleš   (suvun nimi)
vulobealde   alapuolella
vulos   alas
vulosguvlui   alaspäin
vuoddját – vuoddján   lähteä ajamaan
vuodja – vuoja   voi; (ei-kiinteä) rasva
vuodjit – vuoján   ajaa
vuoigŋat – vuoiŋŋan   hengittää
vuoiŋŋastit – vuoiŋŋastan   levätä
vuojehit – vuojehan   ajaa (takaa, edellään)
vuokta – vuovtta   hius
vuolde   alla, alta
vuolgga – vuolgaga   lähtö   
vuolgit – vuolggán   lähteä, mennä
vuolimus – vuolimusa   alimmainen, alin
vuolla – vuola   olut
vuollái   alle
vuollegaš – vuolegačča, #vuollegis   matala (ei vedestä)
vuolšut – *vuolššun   tulehtua
vuoni – vuotnáma   anoppi
vuordit – vuorddán   odottaa
vuorru – vuoru   vuoro
vuos   vielä; ensin
vuossárga – vuossárgga   maanantai
vuos'su – vuossu   palje, palkeet
vuostá   vastaan
vuostá – vuosttá   juusto
vuosttas ~ vuosttaš   ensimmäinen
vuoš'šat – vuoššan   keittää
vuot   taas
vuovdi – vuovddi   metsä
vuovdi – vuovdi   myyjä
vuovdit – vuovddán   myydä
 


