rávdu	N	rautu	pikkunieriä
veajet	N	kalanpoikanen	pikkukala	kulmakko
veajehaš	N	kalanpoikanen	pikkukala
jeđe	Adv	ja sitten
mearradihkki	N	meritäi
vilba	N	miespuolinen serkku
vilbbaš	N	serkus (miespuolinen)
vilbealli	N	poikaserkku
oarpmealli	N	serkku (naispuolinen)
oambealle	N	serkku (naispuolinen)
oarmbealle	N	serkku (naispuolinen)
oarpme(n)bealli	N	serkku (naispuolinen)
ráfuheapmeáigi	N	rauhoitusaika
ráfoheapmeáigi	N	rauhoitusaika
ráfuheapmi	N	rauhoitus
ráfoheapmi	N	rauhoitus
biergodáigi	N	jauheliha
reservašuvdna	N	varaus
várašupmi	N	varaus
dálvečuoččot	N	talvikko (lohesta)	porotokan seisotuspaikka talvella
šoaran	N	talvikko, edellisenä syksynä kutenut lohi
čuonžá	N	talvikko (kutematon, yl kudun jälkeen noussut ja joessa talvehtinut lihavahko lohi keväällä)
vuorru	N	talvikko	(tavallisesti naaraspuolinen)	joessa talvehtinut lohi
gillilvuohta	N	kestävyys	uutteruus	pitkäjänteisyys	lannistumattomuus
eanan	N	maa
bastohis	A	tylsä, pystymätön (puukosta, viikatteesta tms)
soavvil	N	harjus	harri
guollebiepmahat	N	kalankasvattamo
áššečilgehus	N	selvitys
čielggadeapmi	N	selvitystyö	selvittäminen	selittäminen		asian selvitys	mietintö
čilgejupmi	N	selitys	selvitys
guorahallan	N	selvittely	selvittäminen	selvitys	pohdinta	pohdiskelu	harkinta
heivehusgávpi	N	sovelluskauppa internetissä
cohkon	A	mataloitunut
Juvravuotna	N	Gandvik (Nesseby)
vuojadanhálla	N	uimahalli
vuojadansále	N	uimahalli
ollesolmmoš	N	aikaihminen	aikuinen
ollesšattot	A	täysikasvuinen	aikuinen
rohttu	N	ankara, nopeasti tarttuva kulkutauti	rutto
čoska	N	koivupölkky	kuppo	kulkutusverkon ohjain, T:n muotoinen, puusta
govččas	N	peitto	peite	verho	kate
guoddá	N	patja (o)	tyyny
boalsttar	N	tyyny
boarsttal	N	tyyny
bolsttar	N	patja
šleađga	N	sähkö
áŋggaštus	N	mielihalu	intohimo
áŋggašeapmi	N	ikävöinti
pánggirdeaddji	N	uurastaja	tulisielu
porsliidna	N	posliini
porseliidna	N	posliini
árvideapmi	N	arvaus
ovttaládje	Adv	tavallaan	eräällä lailla	samalla tavoin (keskenään)
dájuhuvvon	A	huijattu
measttii	Adv	melkein (R)
bakto	Adv	kautta (R)
meantaš	N	myyttinen peura	Kuolan niemimaan alueella legendan esiäiti, hirven tai villiporon muodossa, jolla on suuret sarvet
baháneahkkán	A	ilkeä	ilkeämielinen	pahantahtoinen	kuriton
láddi	N	lantalainen	suomalainen	suomi	suomen kieli
dassáziigo	Adv	siihen asti kun
gieres	N	ahkio	pulkka
geres	N	ahkio	pulkka
gerres	N	ahkio	pulkka
muoddáádja	N	karhu	peskiäijä
guoccatdákti	N	penisluu	
guoccat	N	(poron, hevosen tms) siitin	suoro
oađđádat	N	vuodevaate	makaus
ilá	Adv	liian	ylen	kovin
aginis	Adv	ikinä	koskaan
raŧŧi	N	ajojälki (lumessa, erityisesti ahkion)	ahkionjälki	tie, maantie (R)
stivrran	N	ratti	ohjauspyörä	ruori	peräsin	ohjain	ohjausosa	rasvaevä
adjágas	N	horros	torkunta
adjagas	N	horros	torkunta
cuipi	A	törröttävä
cuipi	N	suippo esine	kärki	piippolakki	pipo	 miehen kaaresuvantolainen lapinlakki	hassu	hoopo
vahkkoviissaid	Adv	viikkokausia
